Team,MatchPlayed,W,D,L,Goals For,Goals Against,Goal Diff,Points
Arsenal,20,16,2,2,47,17,30,50
Man City,20,14,3,3,53,21,32,45
Newcastle,20,11,8,1,38,12,26,41
Man United,20,12,4,4,32,24,8,40
Brighton,20,11,3,6,38,25,13,36
Tottenham,20,10,3,7,39,31,8,33
Liverpool,20,9,5,6,36,25,11,32
Brentford,20,8,8,4,34,28,6,32
Fulham,20,9,4,7,32,29,3,31
Chelsea,20,8,5,7,22,21,1,29
Aston Villa,20,8,4,8,24,28,-4,28
Crystal Palace,20,6,5,9,18,28,-10,23
Leeds,20,5,6,9,30,36,-6,21
Nottingham,20,5,5,10,16,36,-20,20
Wolves,20,4,5,11,12,29,-17,17
Leicester,20,5,2,13,27,35,-8,17
Bournemouth,20,4,4,12,18,43,-25,16
Southampton,20,4,3,13,17,36,-19,15
Everton,20,3,6,11,15,30,-15,15
West Ham,20,4,3,13,16,30,-14,15
